1111111111111111111111111111111
1110000000000002000000000000111
1120000000500011100050000000211
1000510011110002000111100150001
1000010012000000000002100100001
1010010010000100010000100100101
1010010010000120210000100100101
1310210200500210120050020120141
1010010010000120210000100100101
1010010010000100010000100100101
1000010012000000000002100100001
1000510011110002000111100150001
1120000000500011100050000000211
1110000000000002000000000000111
1111111111111111111111111111111
