1111111111111111111111111111111
1110000000000002000000000000111
1120000000000011100000000000211
1000010011110002000111100100001
1000010012000000000002100104001
1010010010000100010000100100101
1010010010000120210000100100101
1010210200000210120000020120101
1010010010000120210000100100101
1010010010000100010000100100101
1003010012000000000002100100001
1000010011110002000111100100001
1120000000000011100000000000211
1110000000000002000000000000111
1111111111111111111111111111111
